1 1 1 1 1 1
1 0 2 0 1 1
1 3 1 1 1 1
1 5 0 0 1 1 1 1 1
1 0 0 0 0 0 0 0 0 1
1 0 0 0 0 0 0 0 0 1
1 0 0 0 0 0 0 5 4 1
1 4 0 0 0 0 0 0 0 1
1 1 1 1 1 1 1 1 1 1